BBBBBBBBBBBBBBBBBBBBBBBBBBBBBBBBBBBBBBBBBBBBBBBBBBBBBB
BAAAAAAAAABAAAAAAAAAAAAAAAAAAAAAAAAAAAAAAAAAAAAAAAAAAB
BAAAAAAAAABAAAAAAAAAAAAAAAAAAAAAAAAAAAAAAAAAAAAAAAAAAB
BBBBBBBBAABAAAAAAAAAAAAAAAAAAAAAAAAAAAAAAAAAAAAAAAAAAB
BAAAAAABAABAAAAAAAABBBBBBBBBBBBBBBBBBBBBBBBBAAAAAAAAAB
BAAAAAABAABAAAAAAAABAAAAAAAAAAAAAAAAAAAAAAABAAAAAAAAAB
BAAAAAABAABBBBBBBBBBAAAAAAAAAAAAAAAAAAAAAAABAAAAAAAAAB
BAAAAAABAAAAAAAAAAAAAABBBBBBBBBBBBBBBBBBAAABAAAAAAAAAB
BAAAAAABAAAAAAAAAAAAAABAAAAAAAAAAAAAAAABAAABAAAAAAAAAB
BAAAAAABBBBBBBBBBBBBBBBAAAAAAAAAAAAAAAABAAABAAAAAAAAAB
BAAAAAAAAAAAAAAAAAAAAAAAAAAAAAAAAAAAAAABAAABAAAAAAAAAB
BAAAAAAAAAAAAAAAAAAAAAAAAAAAAAAAAAAAAAABAAABAAAAAAAAAB
BAAAAAAAAAAAABBBBBBBBBBBBBBBBBBBBBBBBBBBAAABAAAAAAAAAB
BAAAAAAAAAAAABAAAAAAAAAAAAAAAAAAAAAAAAAAAAABAAAAAAAAAB
BAAAAAAAAAAAABAAAAAAAAAAAAAAAAAAAAAAAAAAAAABAAAAAAAAAB
BAAAAAAAAAAAABAAAAAAABBBBBBBBBBBBBBBBBBBBBBBAAAAAAAAAB
BAAAAAAAAAAAABAAAAAAABAAAAAAAAAAAAAAAAAAAAAAAAAAAAAAAB
BAAAAAAAAAAAABAAAAAAABAAAAAAAAAAAAAAAAAAAAAAAAAAAAAAAB
BAAAAAAAAAAAABAAAAAAABAAAAAAAAAAAAAAAAAAAAAAAAAAAAAAAB
BAAAAAAAAAAAABAAAAAAABAAAAAAAAAAAAAAAAAAAAAAAAAAAAAAAB
BAAAAAAAAAAAABAAAAAAABAAAAAAAAAAAAAAAAAAAAAAAAAAAAAAAB
BAAAAAAAAAAAABAAAAAAABBBBBBBBBBBBBBBBBBBBBAAAAAAAAAAAB
BAAAAAAAAAAAABAAAAAAAAAAAAAAAAAAAAAAAAAAABAAAAAAAAAAAB
BAAAAAAAAAAAABAAAAAAAAAAAAAAAAAAAAAAAAAAABAAAAAAAAAAAB
BAAAAAAAAAAAABBBBBBBBBBBBBBBBBBBBBBBBAAAABAAAAAAAAAAAB
BAAAAAAAAAAAAAAAAAAAAAAAAAAAAAAAAAAABAAAABAAAAAAAAAAAB
BAAAAAAAAAAAAAAAAAAAAAAAAAAAAAAAAAAABAAAABAAAAAAAAAAAB
BAAAAAAAAAAAAAAAAAAAAAAAAAAAAAAAAAAABAAAABAAAAAAAAAAAB
BAAAAAAAAAAAAAAAAAAAAAAAAAAAAAAAAAAABAAAABAAAAAAAAAAAB
BAAAAAAAAAAAAAAAAAAAAAAAAAAAAAAAAAAABAAAABAAAAAAAAAAAB
BAAAAAAAAAAAAAAAAAAAAAAAAAAAAAAAAAAABAAAABBBBBBBBBBBBB
BAAAAAAAAAAAAAAAAAAAAAAAAAAAAAAAAAAABAAAAAAAAAAAAAAAAA
BAAAAAAAAAAAAAAAAAAAAAAAAAAAAAAAAAAABAAAAAAAAAAAAAAAAA
BAAAAAAAAAAAAAAAAAAAAAAAAAAAAAAAAAAABAAAAAAAAAAAAAAAAA
BAAAAAAAAAAAAAAAAAAAAAAAAAAAAAAAAAAABBBBBBBBBBBBBBBBBB
BAAAAAAAAAAAAAAAAAAAAAAAAAAAAAAAAAAAAAAAAAAAAAAAAAAAAB
BAAAAAAAAAAAAAAAAAAAAAAAAAAAAAAAAAAAAAAAAAAAAAAAAAAAAB
BBBBBBBBBBBBBBBBBBBBBBBBBBBBBBBBBBBBBBBBBBBBBBBBBBBBBB
